W W W W W W W W W W W W W W W W W W W W W W W W W W W W
W S S S S S S S S S S S S W W S S S S S S S S S S S S W
W S W W W W S W W W W W S W W S W W W W W S W W W W S W
W B W W W W S W W W W W S W W S W W W W W S W W W W B W
W S W W W W S W W W W W S W W S W W W W W S W W W W S W
W S S S S S S S S S S S S S S S S S S S S S S S S S S W
W S W W W W S W W S W W W W W W W W S W W S W W W W S W
W S W W W W S W W S W W W W W W W W S W W S W W W W S W
W S S S S S S W W S S S S W W S S S S W W S S S S S S W
W W W W W W S W W W W W E W W E W W W W W S W W W W W W
E E E E E W S W W W W W E W W E W W W W W S W E E E E E
E E E E E W S W W E E E E E E E E E E W W S W E E E E E
W W W W W W S W W E W E E W W E E W E W W S W W W W W W
E E E E E E S W W E W 0 E E E E 1 W E W W S E E E E E E
E E E E E E S E E E W E E E E E E W E E E S E E E E E E
E E E E E E S W W E W 2 E E E E 3 W E W W S E E E E E E
W W W W W W S W W E W W W W W W W W E W W S W W W W W W
E E E E E W S W W E E E E E E E E E E W W S W E E E E E
E E E E E W S W W E W W W W W W W W E W W S W E E E E E
W W W W W W S W W E W W W W W W W W E W W S W W W W W W
W S S S S S S S S S S S S W W S S S S S S S S S S S S W
W S W W W W S W W W W W S W W S W W W W W S W W W W S W
W S W W W W S W W W W W S W W S W W W W W S W W W W S W
W B S S W W S S S S S S S S P S S S S S S S W W S S B W
W W W S W W S W W S W W W W W W W W S W W S W W S W W W
W W W S W W S W W S W W W W W W W W S W W S W W S W W W
W S S S S S S W W S S S S W W S S S S W W S S S S S S W
W S W W W W W W W W W W S W W S W W W W W W W W W W S W
W S W W W W W W W W W W S W W S W W W W W W W W W W S W
W S S S S S S S S S S S S S S S S S S S S S S S S S S W
W W W W W W W W W W W W W W W W W W W W W W W W W W W W